0,0,0,0,0,0,0,0,0,0,184,185,0,0,0,0,0,0,0,0,0,0,0,0,186,187,0,0,0,0,
0,0,0,0,0,0,0,0,0,0,200,201,0,0,0,0,0,0,0,0,0,0,0,0,202,203,0,0,0,0,
0,0,88,0,0,0,0,88,0,0,216,217,0,0,0,0,0,0,0,0,0,0,0,0,218,219,0,0,88,0,
0,0,88,171,172,173,174,88,0,0,0,0,0,0,0,0,0,171,172,173,174,0,0,171,172,173,174,0,0,0,
0,0,0,0,0,0,0,0,0,0,0,0,0,0,0,0,0,0,0,0,0,0,0,0,0,0,0,0,0,0,
0,0,0,0,0,0,0,0,0,0,0,0,0,0,0,0,0,0,0,0,0,0,0,0,0,0,0,0,0,0,
88,88,88,171,172,173,174,88,0,0,0,0,0,0,0,0,0,171,172,173,174,0,0,171,172,173,174,0,0,0,
0,0,0,0,0,0,0,0,0,0,0,0,0,0,0,0,0,0,0,0,0,0,0,0,0,0,0,0,0,0,
81,82,83,84,0,0,0,0,0,0,0,0,0,0,0,0,0,0,0,0,0,0,0,0,0,0,88,0,0,0,
97,98,99,100,0,0,0,0,0,0,0,0,0,0,0,0,0,0,0,0,0,0,0,0,0,0,88,0,0,0